5 10
|========|
|...|..-.|
|..-|.@..|
|......|.|
|========|