5 10
|========|
|...|..|.|
|.--|.@..|
|......|.|
|========|